



###################################################################################
##                                                                         #####
#                                                                            ###
#                                              %                               #
#      @       $                                                               #
##                                               $                             #
#                                                                              #
#                            %                                                 #
#                                                                 ####         #
#                      ##############                                          #
#                                   #                         $               ##
#                      ###      >   #                                        ###
#       %                #          #                                         ##
#                        #          #              ##        %                 #
#                        ############             ####                  $      #
#                                                  ##                          #
#             %              %                                 %               #
#                                                                              #
#           %                               $                                  #
#                                                    ##          ##            #
#################################################################################

