


############################################################################################
##                                                                         ######
#                                   ####                                     ###
#                                                                              #
#                                                                              #
##                #####                                                        #
#                                                                              #
#                       #  # #  # #   #   #                      ####          #
#      ##                      #                                 ####          #
#       #               ##############                                         #
#                                   #                                         ##
#                      ###          #                                        ###
#                        #          #                                         ##
#                        #          #              ##                          #
#                        ############             ####                         #
#                                                  ##                          #
#                                                                              #
#  #   #    #                                                     ###     ######
#                                                                 ##           #
#  #   #    #                                                     ##          ##
#                                                                 ##        ####
############################################################################################
